R 1920 1080

NO ./textures/text_east.xpm
SO ./textures/text_east.xpm
WE ./textures/text_east.xpm
EA ./textures/text_east.xpm
S  ./textures/barrel.xpm

F 255,10,10
C 10,10,255

                                                 11111111111111111111111
        1111111111111111111111111111111111111111110000000000000000000021
        1000000000110000000000000000000000000000000000000000000000000001
        1011000001110000002000001111111111111111110000111111111111120001
        1001000000000000000000001                100001           100001
111111111011000001110000002000001                100001           100201
100000000011000001110111111111111      111111111110000111         100001
11110111111111011100000010001          100000000000000001         100N01
11110111111111011101010010001          100001111111110001         100001
110000001101010111000000100011111111111100001       10001         120001
100020000000000011000000000000000000000000021       10001         100021
100000000000000011010100100011111111111100001       10001         100001
1000000111010101111101111000111        100001111111110001         120001
10110111 1110101 101111010001          100000000000000001         100001
10111111 1110111 111111111111          111111110001111111         100201
101        101                                10001               100001
101        101                                10001               100001
101        101                      111111111110001111111111111111102001
101        1011111111111111111111111100000000000000000000000000000000001
101        1000000000000000000000000000000000000001111111111111111100001
101        1111111111111111111111111111111100011111               100001
101                                       10001                   100021
101                                       10001                   100001
101                                       10001                   120001
101                                       10001                   100001
101                                       100011111111111111111111100001
101111111111111111111111111111111111111111100000000000000000000000000021
100000000000000000000000000000000000000000000000000000000000000000200001
111111111111111111111111111111111111111111111111111111111111111111111111